...................................
...................................
........................X..........
.......X.................X.........
........X.............XXXX.........
......XXX..........................
....................XXXXX..........
.........X.........................
.........XXX.......................
..........X........................
................XXXXX..............
...................................
...................................
