...................................
...................................
.....XX................XX..........
.....XX...............X..X.........
.......................XX..........
............XX.....................
............X.X....................
.............X..........XX.........
.......................X..X........
.....X..................X.X........
....X.X..................X.........
...................................
...................................
